111111111111111111111111111111111111111111111111111111111111
1000000000000001E1111111111111111111111111111111111111111111
100000111100000101111111111111111111111111111111111111111111
100000000C10000001111111111111111111111111111111111111111111
100000001111100001111111111111111111111111111111111111111111
111000000000000111111111111111111111111111111111111111111111
1P0000000000000101111111111111111111111111111111111111111111
111111111111111111111111111111111111111111111111111111111111
