1111111111111111111111111
1001000000011100000111111
1P00011111001000000000001
1000000000010000000000111
10C00C000C0000CCC000000E1
1111111111111111111111111
