111111
110001
110PE1
100001
111111
