111111
110001
110PE1
10C001
111111
