111111
102P01
10C001
1110E1
111111
