111111
100P01
10C001
1110E1
111111
