11111
100P1
10C01
111E1
11111
