11111
110001
111PE1
11C101
111111
